30 seconds=30 секунд
1 minute=1 хвилина
2 minutes=2 хвилини
5 minutes=5 хвилин
10 minutes=10 хвилини
30 minutes=30 хвилини
1 hour=1 година
2 hours=2 години
Above=Понад
Array must be Started to view disk stats=Щоб переглянути статистику диска, масив має бути **запущений**
Array must be Started to view system stats=Для перегляду системної статистики масив має бути **запущений**
Available for Data=Доступно для даних
Below=Нижче
CPU Load=Завантаження CPU
Disk Usage=Використання диска
disks=диски
High on Usage=Високий рівень використання
Last day=Останній день
Last 2 days=Останні 2 дні
Last 3 days=Останні 3 дні
Last week=Минулого тижня
Last 2 weeks=Останні 2 тижні
Last 3 weeks=Останні 3 тижні
Last month=Минулого місяця
Low on Space=Мало місця
Normal Usage=Нормальне використання
Real-time=Реальний час
Since start=З початку
Storage=Сховище
Total Array Size=Загальний розмір масиву
Total Space Used=Загальний використаний простір
Used for Parity=Використовується для паритету
utilization in percentage=використання у відсотках
