Automatic theming=Автоматичне оформлення тем
Bing API key=Ключ API Bing
Bing=Bing
City name=Назва міста
Country name=Назва країни
Day theme=Тема дня
Geocoding service=Сервіс геокодування
Google API key=Ключ Google API
Google=Google
MapQuest API key=Ключ MapQuest API
MapQuest=MapQuest
Night theme=Нічна тема
No geographical coordinates found for the given address=Для вказаної адреси не знайдено географічних координат
Please adjust=Будь ласка, налаштуйте
Postal code=Поштовий індекс
See=Побачити
Street address=Адреса вулиці
this site=цей сайт
to obtain a Bing API key=щоб отримати ключ API Bing
to obtain a Google API key=щоб отримати ключ Google API
to obtain a MapQuest API key=щоб отримати ключ MapQuest API

:day_night_plug:
> Введіть інформацію про свою адресу (вулиця, місто, країна), яка використовується для розрахунку часу сходу та заходу сонця у вашому місці.
>
> Служба геокодування використовується для перетворення вашої адреси в географічні (широта та довгота) координати.<br>
> Вам потрібно зареєструватися в одному з доступних сервісів і отримати унікальний ключ API, щоб користуватися його сервісом.
>
> Тема **день** вибирається між сходом і заходом сонця<br>
> Тема **ніч** вибирається між заходом і сходом сонця
:end
