%s ago=%s назад
%s used of %s %s %%=%s зайнято із %s (%s %%)
1 m=1 м
10 s=10 с
2 m=2 м
30 s=30 с
5 m=м
Abort background operation=Перервати фонову операцію
Abort background process=Перервати фоновий процес
Active tunnels=Активні туннелі
Activity=Активність
ago=назад
Airflow=Охолодження
Alert Message=Попереджувальне повідомлення
Alerts=Оповіщення
All Apps=Усі Програми
All VMs=Усі VMs
Array Information=Інформація про масив
Attention - operation continues in background=Увага - робота триває у фоновому режимі
Battery charge=Заряд батареї
BIOS dated=BIOS датований
Check free space=Перевірте вільний простір
Click to toggle CPU chart=Натисніть, щоб перемкнути діаграму CPU
Click to toggle details=Натисніть, щоб перемкнути деталі
Clock is unsynchronized with no NTP servers=Годинник не синхронізовано, немає серверів NTP
Clock synchronized with %s NTP server=Годинник синхронізовано з NTP-сервером %s
Clock synchronized with %s NTP servers=Годинник синхронізовано з %s серверами NTP
Clone=Клонування
Close Tile=Закрити плитку
Completed=Завершено
Containers=Контейнери
Content Management=Управління вмістом
Counters info=Інф. про лічильники
Current operation %s on %s=Поточна операція %s на **%s**
custom image=зображення користувача
Data is invalid=Некоректні дані
default image=зображення за замовчуванням
Docker Containers=Docker Контейнери
Docker folder=Папка Docker
Docker vdisk=Докер vdisk
Due in=Через
Edit VM after clone=Редагувати віртуальну машину після клонування
Elapsed time=Витрачений час
Errors info=Інф. про помилки
Estimated finish=Орієнтовна обробка
failed device=несправний пристрій
Fan count=Кількість вентиляторів
Fan Information=Інформація про кулер
FAN=FAN
Finding %s error=Знайдена: **%s** помилка
Finding %s errors=Знайдено: **%s** помилок
Flash device=Flash-пристрій
Free=Вільно
General info=Загальна інформація
Go to CPU pinning settings=Перейти до налаштувань CPU
Go to date and time settings=Перейдіть до налаштувань дати та часу
Go to disk settings=Перейти до налаштувань диска
Go to Docker settings=Перейти до налаштувань Docker
Go to fan settings=Перейти до налаштувань вентиляторів
Go to identification settings=Перейти до налаштувань ідентифікації
Go to network settings=Перейти до налаштувань мережевіх інтерфейсів
Go to scheduler settings=Перейти до налаштувань планувальника
Go to Share settings=Перейти до налаштувань спільного доступу
Go to UPS settings=Перейти до налаштувань UPS
Go to User settings=Перейти до налаштувань користувачів
Go to VM settings=Перейти до налаштувань VM
Go to VPN settings=Перейти до налаштувань VPN
Handshake=Рукостискання
has=має
healthy=в порядку
heat warning=попередження про перегрів
Hide details=Приховати деталі
in progress=в процесі
Inactive tunnels=Неактивні тунелі
inactive=неактивний
Inbound=Вхідний
Information=Інформація
Interface Information=Інформація про інтерфейс
invalid device=недійсний пристрій
invalid devices=недійсні пристрої
Last check completed on %s=Остання перевірка завершена **%s**
Last check incomplete on %s=Остання перевірка не завершена **%s**
Last checked on %s=Востаннє перевірено **%s**
Legend=Легенда
Lock sortable items=Блокування елементів, які можна сортувати
Log filesystem=Журнал Файлової системи
Maximum size=Макс. розмір
Memory Utilization=Використання пам'яті
Mode of operation=Режим роботи
Motherboard Information=Інформація про материнську плату
Network traffic=Трафік Мережі
New VM=Нова VM
Next check scheduled on %s=Наступна перевірка запланована на **%s**
No docker containers defined=Контейнери докерів не визначені
No running docker containers=Немає запущених Docker контейнерів
No running virtual machines=Немає запущених віртуальних машин
No shares present=Нема загальних ресурсів
No virtual machines defined=Віртуальні машини не визначені
Nominal power=Номінальна потужність
not received=не отримав
Notices=Сповіщення
Notifications=Повідомлення
Only PNG images are allowed=Дозволені лише зображення PNG!
Outbound=Вихідний
Output voltage=Вихідна напруга
Overall Load=Загальне навантаження
Overwrite=Перезаписати
Parity disk not present=Диска парності немає
Parity disks not present=Дисків парності немає
Parity has not been checked yet=Парність ще не перевірена
Parity Information=Інформація про паритет
Parity is degraded=Паритет погіршується
Percent of total used memory=Відсоток загальної використаної пам'яті
Percent usage of Docker folder=Відсоток використання папки Docker
Percent usage of Docker vdisk=Відсоток використання Docker vdisk
Percent usage of flash usb device=Відсоток використання флеш-пристрою USB
Percent usage of LOG file system=Відсоток використання файлової системи LOG
Pool=Пул
Power Status=Стан живлення
Power=Живлення
Processor Information=Інформація про процесор
Put system to sleep=Перевести систему в режим сну
RAM usage=використання Оперативної Пам'яті
Reboot the system=Перезавантажити систему
Receive counters=Прийом лічильників
Received packets=Отримані пакети
Runtime left=Залишився час виконання
Scheduled parity check is disabled=Запланована перевірка на парність вимкнена
Select Case Model=Виберіть модель корпусу
Select time frame=Виберіть часові рамки
Services=Послуги
Share count %s with %s cache only and %s encrypted=Кількість використання: **%s** з **%s** тільки кеш і зашифрованим **%s**
Shares Information=Ділитися інформацією
Show details=Показати деталі
Show Information=Показати інформацію
ShowHide All Content=Показати / Приховати Весь вміст
ShowHide Content=Показати / Приховати Вміст
Shutdown the system=Вимкнути систему
SMART error=SMART помилка
SMART health-check failed=Помилка перевірки працездатності SMART
SMART=SMART
sn=с/н
Snapshot Name=Назва Знімка
Snapshot=Знімок
Start Cloned VM=Запустіть Клонування VM
Start the array=Запустити масив
Started only=Тільки запустити
Stop the array=Зупинити масив
Temp=Температура
This may leave an unknown state=Це може залишити невідомий стан
This will put the system to sleep=Це переведе систему в режим сну
This will reboot the system=Це призведе до перезавантаження системи
This will shutdown the system=Це призведе до вимкнення системи
This will start the array=Це запустить масив
This will stop the array=Це зупинить масив
Tile Management=Менеджмент Плиток
Transmit counters=Лічильники передачі
Transmitted packets=Передані пакети
Unassigned Devices=Непризначені пристрої
Unlock sortable items=Розблокуйте предмети, які можна сортувати
UPS Load=Навантаження UPS
UPS Model=Модель UPS
UPS status=Статус UPS
Usable size=Придатний розмір
User count %s with %s unprotected=Кількість користувачів %s із незахищеним %s
Users Information=Інформація про користувачів
utilization warning=попередження про використання
View Running Processes=Перегляд запущених процесів
Virtual Machines=Віртуальні машини
VM Being Cloned=VM Клонується
VM Clone=Клон VM
VM Name=Назва VM
VPN Connections=Підключення VPN
W=В
Warnings=Попередження
ZFS=ZFS
