Access Mode=Режим доступу
Add another Path, Port, Variable, Label or Device=Додайте інший шлях, порт, змінну, мітку або пристрій
Add Configuration=Додати конфігурацію
Add=Додати
Additional Requirements=Додаткові вимоги
Always=Завжди
App to Host=Додаток на хост
Application=Застосування
apply update=застосувати оновлення
Array must be Started to view Docker containers=Для перегляду контейнерів Docker необхідно **запустити** масив
Are you sure=Ти впевнений
Autostart=Авто старт
Back=Назад
Backup=Резервне копіювання
Beta=Бета-версія
Books=Книги
By=В
Categories=Категорії
Check for Updates=Перевірити наявність оновлень
Cloud=Cloud
Config Type=Тип конфігурації
Configuration not found=Конфігурацію не знайдено
Connection Type=Тип підключення
Console shell command=Команда консольної оболонки
Container ID=ID Контейнера
Container Path=Шлях Контейнера
Container Port=Порт Контейнера
Container Size=Розмір Контейнера
Container=Контейнер
CPU Memory load=Завантаження CPU та Memory
CPU Pinning=Закріплення CPU
Created=Створено
Crypto Currency=Криптовалюта
Default Value=Значення за замовчуванням
Device=Пристрій
Display=Дисплей
DNS=DNS
Docker Containers=Docker Контейнери
Docker Hub URL=URL-адреса Docker Hub
Docker Service failed to start=Не вдалося запустити службу Docker
Downloaders=Завантажувачі
Drivers=Драйвера
Edit Configuration=Редагувати конфігурацію
Exited=Вийшов
Extra Parameters=Додаткові параметри
Fixed IP address=Фіксована IP-адреса
force update=швидке оновлення
FTP=FTP
Game Servers=Ігрові Сервери
healthy=здоровий
Hide Buttons=Приховати кнопки
Hide docker allocations=Приховати виділення Dockers
Hide more settings=Приховати інші налаштування
Home Automation=Домашня Автоматизація
Host Path=Шлях Хоста
Host Port=Порт Хоста
HT=HT
Icon URL=URL-адреса значка
Image ID=Образ ID
Key=Ключ
Label=Етикетка
Management=Менеджмент
MediaApp=MediaApp
MediaServer=Медіасервер
Messenger=Месенджер
Missing parameters=Відсутні параметри
Music=Музика
Network Type=Тип мережі
No Docker containers installed=Не встановлено контейнери Docker
None Listed=Немає в списку
of=з
orphan image=
Other=Інший
Overview=Огляд
Path=Шлях
Pause All=Призупинити все
Photos=Фотографії
Port Mappings=Відображення портів
Port=
Post Arguments=Аргументи публікації
Privileged=Привілейований
Productivity=Продуктивність
Project Page=Сторінка проекту
Proxy=Проксі
Pulling image=Витягування образ
Read Me First=Спочатку Прочитай Мене
Read Only - Shared=Лише читання – Shared
Read Only - Slave=Лише читання – Slave
Read Only=Лише Читання
ReadWrite - Shared=Читання/запис – Shared
ReadWrite - Slave=Читання/запис - Slave
rebuild ready=перебудувати готовий
rebuilding=перебудова
Remove template=Видалити шаблон
Removing container=Видалення контейнера
Removing orphan image=
Repository=Репозиторій
Required=
Reset sorting=Скинути сортування
Resume All=Відновити ВСІ
Save=Зберегти
Select a template=Виберіть шаблон
Select categories=Виберіть категорії
Show docker allocations=Показати розподіл докерів
Show more settings=Показати більше налаштувань
Stable=Стабільний
Start All=Запустити ВСІ
starting up containers=запуск контейнерів
Stop All=Зупинити ВСІ
Stopping container=Зупинення контейнера
Successfully removed container=Контейнер успішно вилучено
Successfully removed orphan image=
Successfully stopped container=Контейнер успішно зупинений
Support Thread=Тема Підтримка
Template URL=URL-адреса шаблону
Template=Шаблон
The command failed=Команда не вдалася
The command finished successfully=Команда завершилася успішно
TOTAL DATA PULLED=ЗАГАЛЬНІ ДАНІ
Total size=Загальний розмір
Unknown action=Невідома дія
Update All=Оновити ВСЕ
update ready=оновлення готове
Value=Значення
Variable=Змінна
Video=Відео
Voip=Voip
Volume Mappings=Відображення Тому
wait=чекати
Was this container created using this plugin=Цей контейнер створено за допомогою цього плагіна
Web=Web
WebUI=WebUI
Writable=Можливий запис
