also remove image=також видалити образ
Apply=Застосувати
Are you sure=Ти впевнений?
Cancel=Скасувати
checking=перевірка
Completely REMOVE=Повністю ВИДАЛИТЬ
Console=Консоль
day=день
days=днів
disk image and definition=образ диска та визначення
Disks=Диски
Donate=Donate
Done=Готово
Edit=Редагувати
Execution error=Помилка виконання
Force Stop=Примусова зупинка
Hibernate=Гібернація
Log for=Log для:
log=log
Logs=Logs
More Info=Більше інформації
No=Ні
OK=ДОБРЕ
Ok=Добре
Pause=Пауза
Proceed=Продовжити
Project Page=Сторінка проекту
Read Me First=Прочитай мене спочатку
Remove container=Видалити контейнер
Remove definition=Видалити визначення
Remove image=Видалити образ
Remove VM=Видалити VM
Remove=Видалити
Restart=Перезапустити
Resume=Відновити
Start=Почати
Stop=Зупинити
Support=Підтримка
Update container=Оновити контейнер
Update=Оновити
Updating all Containers=Оновлення всіх контейнерів
Updating the container=Оновлення контейнера
VNC Remote=VNC Remote
WebUI=WebUI
Yes, delete it=Так, видалити!
Yes, update it=Так, оновити!
Yes=Так

; footer messages
Array Copying=Копіювання масиву
Array Clearing=Очищення масиву
Array Starting=Запуск масиву
Array Stopping=Зупинка масиву
Mounting disks=Монтаж дисків
Retry unmounting user shares=Повторити спробу демонтування спільних користувачів
Spinning up all drives=Розкручування всіх дисків
Stale configuration=Застаріла конфігурація
Starting services=Запуск сервісу
Stopping services=Зупинка сервісу
Starting Recycle Bin=Запуск очищення кошика
Stopping Recycle Bin=Зупинка очищення кошика
Sync filesystems=Синхронізація файлових систем
Unmounting disks=Демонтування дисків
Autostart disabled=Автозапуск вимкнено
Missing encryption key=Відсутній ключ шифрування
Opening encrypted volumes=Відкриття зашифрованих томів

; docker variables
Container Path=Контейнерний Шлях
Container Port=Контейнерний Порт
Container Variable=Контейнерна Змінна
Container Label=Мітка Контейнера
Container Device=Контейнерний Пристрій
