A format is NEVER part of a data recovery or disk rebuild process and if done in such circumstances will normally lead to loss of all data on the disks being formatted=Форматування **НІКОЛИ** є частиною процесу відновлення даних або відновлення диска, і якщо це зробити за таких обставин, зазвичай призведе до втрати всіх даних на дисках, які форматуються.
Aborted=Перервано
Action=Дія
Add=Додати
Add Pool=Додати пул
All existing data on this device will be OVERWRITTEN when array is Started=Усі наявні дані на цьому пристрої будуть ПЕРЕЗАПИСАНІ після запуску масиву
Array Devices=Пристрої масиву
Array of %s devices=Масив пристроїв %s
Array Operation=Операція з масивом
Attribute Name=Назва атрибута
Attributes=Атрибути
auto=авто
Balance Status=Стан балансу
Balance=Баланс
Blacklisted=У чорному списку
Boot Device=Boot пристрій
Boot system in UEFI mode=Завантаження системи в режимі UEFI
btrfs balance status=стан балансу btrfs
btrfs check status=btrfs перевірити статус
btrfs filesystem df=Файлова система btrfs df
BTRFS operation is running=Запущена операція BTRFS
btrfs scrub status=Статус очищення btrfs
Can not read attributes=Не можу прочитати атрибути
Can not read capabilities=Не можу прочитати можливості
Can not read identification=Не можу прочитати ідентифікацію
Canceled=Скасовано
Cannot contact key-server Please check your=Неможливо зв'язатися з сервером ключів. Будь ласка, перевірте свій
Capabilities=Можливості
Check Filesystem Status=Перевірте стан файлової системи
Clear Stats=Очистити статистику
Clearing in progress=Триває очищення
Click on FLASH above this message=Натисніть на **FLASH** над цим повідомленням
Click to spin down device=Натисніть, щоб розкрутити пристрій
Click to spin up device=Натисніть, щоб розгорнути пристрій
Comments=Коментарі
complete=завершено
completed=завершено
Completed without error=Виконано без помилок
Configuration valid=Конфігурація дійсна
Convert to raid0 mode=Перевести в режим raid0
Convert to raid1 mode=Перевести в режим raid1
Convert to raid10 mode=Перевести в режим raid10
Convert to raid1c3 mode=Перевести в режим raid1c3
Convert to raid1c4 mode=Перевести в режим raid1c4
Convert to raid5 mode see help=Перейти в режим raid5 *дивіться довідку
Convert to raid6 mode see help=Перейти в режим raid6 *дивіться довідку
Convert to single mode=Перевести в одиночний режим
Copying=Копіювання
corrected=виправлений
Create an empty file system on the disks shown as Unmountable discarding all data currently on the disks and update parity to reflect this=Створіть порожню файлову систему на дисках, які відображаються як **Незмонтовані**, відкидаючи всі дані на дисках, і оновіть паритет, щоб відобразити це
Creating Flash backup=Створення резервної копії Flash
creating Flash backup zip file this may take several minutes=створення ZIP-файлу резервної копії Flash (це може зайняти кілька хвилин)
Creation error=Помилка створення
Critical disk temperature threshold=Критичний поріг температури диска
Critical disk utilization threshold=Критичний поріг використання диска
Current operation %s on %s=Поточна операція %s на **%s**
Current position=Поточна позиція
Custom attributes use comma to separate numbers=Спеціальні атрибути (використовуйте кому для розділення чисел)
Data-Rebuild in progress=Виконується відновлення даних
Date of purchase=Дата покупки
Date=Дата
Delete Pool=Видалити Pool
detected=виявлено
Device encrypted and unlocked=Пристрій зашифровано та розблоковано
Device encrypted=Пристрій зашифровано
Device is part of a pool=Пристрій є частиною pool
Device locked unknown error=Пристрій заблоковано: невідома помилка
Device locked wrong encryption key=Пристрій заблоковано: неправильний ключ шифрування
Device to be encrypted=Пристрій для шифрування
Disable Spin down delay to run a SMART extended self-test=Вимкніть **Затримку обертання**, щоб запустити розширене самотестування SMART
Disk in parity slot is not biggest=Диск в слоті паритету не найбільший
Disk Log Information=Інформація про дисковий журнал
Disk-Clear in progress=Виконується очищення диска
Do not use reserved names=Не використовуйте зарезервовані імена
Do not use user share names=Не використовуйте імена спільного доступу користувачів
Download SMART report=Завантажити звіт SMART
Dual parity valid requires ALL disks in their original slots=*Dual parity* потрібні **ALL** диски в оригінальних слотах
Elapsed time=Витрачений час
Enable user share assignment=Увімкнути призначення спільного доступу користувачам
enter disk index and device name as applicable to your controller=введіть індекс диска та назву пристрою відповідно до вашого контролера
Erase Device Content=Стерти вміст пристрою
encrypted=зашифрований
Encryption input=Вхід шифрування
Encryption status=Статус шифрування
Enter new key=Введіть новий ключ
Errors occurred - Check SMART report=Сталися помилки - Перевірте звіт SMART
Estimated finish=Орієнтовна обробка
Estimated speed=Розрахункова швидкість
Existing content is permanently lost=Існуючий вміст остаточно втрачено
Failed=Не вдалося
Feature=Особливість
File system status=Стан файлової системи
File system type=Тип файлової системи
Finding %s error=Знайдено: помилку **%s**
Finding %s errors=Виявлено: **%s** помилок
Flag=Флаг
Flash backup=Flash-резервне копіювання
Flash device is set as public share=Flash-пристрій встановлено як загальнодоступний
Flash Device Settings=Налаштування Flash-пристрою
Format Unmountable disks=Форматувати немонтовані диски
Formatting=Форматування
formatting=форматування
Free=Вільно
FS=FS
Global Configuration=Глобальна конфігурація
Hide=Сховати
Identification=Ідентифікація
Identity=Ідентичність
if checked, Start array but do not mount disks=якщо позначено, запустити масив, але не монтувати диски
If this is a new array, move the largest disk into the parity slot=Якщо це новий масив, перемістіть найбільший диск у слот *parity*
If you are adding a new disk or replacing a disabled disk, try Parity-Swap=Якщо ви додаєте новий диск або замінюєте вимкнений диск, спробуйте Parity-Swap
Information=Інформація
Insufficient free disk space available=Недостатньо вільного місця на диску
Interrupted=Перерваний
Invalid configuration=Недійсна конфігурація
invalid device=недійсний пристрій
invalid devices=недійсні пристрої
Invalid expansion=Недійсне розширення
Invalid pool name=Недійсна назва пулу
Invalid, missing or expired=Недійсний, відсутній або прострочений
is only available when array is Started in Maintenance mode=доступний лише тоді, коли масив запущено в режимі **Обслуговування**
is only available when array is Started=доступний лише тоді, коли масив запущено
Keyfile=Файл ключа
Last check completed on %s=Остання перевірка завершена **%s**
Last check incomplete on %s=Остання перевірка не завершена **%s**
Last checked on %s=Востаннє перевірено **%s**
Last SMART test result=Результат останнього тесту SMART
Maintenance mode=Режим обслуговування
Maintenance Mode=Режим Обслуговування
Maintenance=Обслуговування
Manufacturing date=Дата виготовлення
Menu View=Перегляд меню
Minimum free space=Мінімум вільного місця
Missing Cache disk=Відсутній Кеш-Диск
Missing disk=Відсутній диск
Missing key=Відсутній ключ
Missing=Відсутняій
Mounted=Монтується
Mover is running=Перенос запущений
network settings=налаштування мережі
next device=наступний пристрій
New data disks detected=Виявлено нові диски з даними
No array data disks have been assigned=Диски з даними масиву не призначені
No data disks=Немає дисків з даними
No parity check history present=Немає історії перевірки на парність
No self-tests logged on this disk=На цьому диску не зареєстровано жодного самотестування
Not installed=Не встановлено
OK=OK
Once copy completes, the array may be Started, to initiate Data-Rebuild of the disabled disk=Після завершення копіювання масив можна запустити, щоб ініціювати відновлення даних вимкненого диска
operation=операція
Options see Help=Параметри (див. Довідку)
Otherwise use the keyfile method for UTF8 input=В іншому випадку використовуйте метод **Файл ключа** для введення UTF8
Parity disks content will be overwritten=Вміст диска(ів) *Parity* буде перезаписано
Parity is already valid=Паритет уже діє
Parity operation is running=Виконується операція паритету
Parity valid requires ALL disks to have their original content=*Парність дійсна* вимагає, щоб **УСІ** диски мали оригінальний вміст
Parity-Check in progress=Виконується перевірка паритету
Parity Operation History=Історія паритетних операцій
ParityRead-Check History=Parity/Read-Check History
Parity-SyncData-Rebuild in progress=Виконується синхронізація паритету/перебудова даних
Parity-Sync in progress=Виконується синхронізація паритету
Partition format=Формат розділу
Partition size=Розмір розділу
Passed=Прийнято
Passphrase=Парольна фраза
Perform full balance=Виконайте повний баланс
Permit UEFI boot mode=Дозволити режим завантаження UEFI
Please change share SMB security=Будь ласка, змініть спільну безпеку SMB
Please check your system settings to support UEFI boot mode=Перевірте налаштування системи на підтримку режиму завантаження UEFI
Pool Devices=Пул пристроїв
Pool name already exists=Назва пулу вже існує
Pool of %s devices=Пул пристроїв %s
Preclear in progress=Виконується попереднє очищення
previous device=попередній пристрій
Printable Characters Only=Лише для друку символи
Proceed to start=Перейти до старту
Raw Value=Raw Значення
Raw View=Переглянути Raw
Read-Check in progress=Триває читання-перевірка
Reading=Читання
Reboot in safe mode=Перезавантаженя в безпечному режимі
registration key=ключ реєстрації
Registration Key Manager=Менеджер ключів реєстрації
reiserfsck status=статус reiserfsck
Rename Pool=Перейменувати Pool
Repair corrupted blocks=Відремонтувати пошкоджені блоки
Replacement disk installed=Установлено замінний диск
Replacement disk is too small=Замінний диск замалий
Retype passphrase=Повторно введіть парольну фразу
Schedule=Розклад
Scrub Status=Статус скрабу
Scrub=Скраб
See %s Settings=Дивіться налаштування %s
self-test in progress=триває самоперевірка
Self-Test=Самоперевірка
Server boot mode=Режим завантаження сервера
Set default boot menu=Встановити меню завантаження за замовчуванням
show passphrase=показати парольну фразу
Show=Показати
Slots=Слоти
SMART attribute notifications=Сповіщення атрибутів SMART
SMART controller type=Тип контролера SMART
SMART error log=Журнал помилок SMART
SMART extended self-test=Розширена самоперевірка SMART
SMART health-check failed=Помилка перевірки працездатності SMART
SMART notification tolerance level=Рівень толерантності сповіщень SMART
SMART notification value=Значення сповіщень SMART
SMART self-test history=Історія самотестування SMART
SMART self-test in progress=Триває самоперевірка SMART
SMART Settings=Налаштування SMART
SMART short self-test=Коротка самоперевірка SMART
SMART status=SMART статус
Speed=Швидкість
Spin down delay=Затримка обертання
Spin Down=Зупинити Обертання
Spin Up=Запустити Обертання
Spinup groups=Співгрупа(и)
Started, array protected=Запущено, масив захищений
Started, array unprotected=Запущено, масив незахищений
Started, clearing=Почали, очищення
Started, formatting=Почали, форматування
Starting, copying=Початок, копіювання
Starting=Початок
Stopping=Зупинка
Sync errors=Помилки синхронізації
Sync errors corrected=Виправлено помилки синхронізації
Sync errors detected=Виявлено помилки синхронізації
Sync=Синхронізувати
Syslinux Configuration=Конфігурація Syslinux
Syslinux configuration=конфігурація Syslinux
Temp=Temp
The array will be immediately available, but unprotected since parity has not been assigned=Масив буде негайно доступний, але **незахищений**, оскільки *парність* не призначено
The array will be immediately available, but unprotected until Parity-Sync completes=Масив буде негайно доступним, але **незахищений**, доки не завершиться Синхронізація Паритету
The replacement disk must be as big or bigger than the original=Змінний диск повинен бути таким же або більшим за оригінальний
This is typically done when a new disk is added to the array to get it ready for files to be written to it=Зазвичай це робиться, коли до масиву додається новий диск, щоб підготувати його до запису на нього файлів
This Unraid OS release has been withdrawn and may no longer be used Please=Цей випуск Unraid OS було відкликано і більше не може використовуватися. Будь ласка
This will ERASE ALL device content=Таким чином БУДЕ СТЕРТО ВЕСЬ вміст пристрою
This will ERASE content of ALL devices in the pool=Це СТИРАЄ вміст ВСІХ пристроїв у пулі
This will reboot the system=Це призведе до перезавантаження системи
This will shutdown the system=Це призведе до вимкнення системи
This will stop the array=Це зупинить масив
This will stop the running operation=Це зупинить запущену операцію
Threshold=Поріг
Title=Назва
To confirm your action type %s=Щоб підтвердити тип дії: %s
Toggle readswrites display=Перемикач відображення читання/запису
Too many attached devices Please consider upgrading your=Забагато підключених пристроїв. Будь ласка, подумайте про оновлення свого
Too many wrong andor missing disks=Забагато неправильних та/або відсутніх дисків
Total size=Загальний розмір
Unassign ALL devices to delete this pool=Скасувати призначення **УСІМ** пристроям, щоб видалити цей пул
Unassigned Devices=Непризначені пристрої
unavailable no parity-check entries logged=недоступно (записи перевірки парності не зареєстровані)
Unavailable - disk must be spun up=Недоступно – диск потрібно розкрутити
Unavailable=Недоступно
Unclean shutdown detected=Виявлено нечисте вимкнення
Unmountable disk present=Присутній немонтований диск
Unmountable disks present=Присутні немонтовані диски
Unmountable Encrypted volume present=Незмонтований: Присутній зашифрований том
Unmountable Missing encryption key=Незмонтований: Відсутній ключ шифрування
Unmountable No file system=Незмонтований: немає файлової системи
Unmountable No pool uuid=Незмонтований: немає пулу uuid
Unmountable not btrfs pool=Незмонтований: не пул btrfs
Unmountable Unsupported or no file system=Незмонтований: Не підтримується або відсутня файлова система
Unmountable Volume not encrypted=Незмонтований: том не зашифрований
Unmounted=Розмонтований
Upgrading diskswapping parity=Оновлення паритету диска/підкачки
Use ASCII characters from space to tilde=Використовуйте символи **ASCII** від пробілу " " до тильди "~"
Use Default=Використовувати за Замовчуванням
Use default=Використовувати за замовчуванням
Use only lowercase with no special characters or leadingtrailing digits=Використовуйте лише нижній регістр без спеціальних символів або початкових/кінцевих цифр
use printable characters only=використовуйте лише друковані символи
Used=Використано
Value=Значення
WARNING canceling may leave the array unprotected=ПОПЕРЕДЖЕННЯ: скасування може залишити масив незахищеним
Warning disk temperature threshold=Попередження про поріг температури диска
Warning disk utilization threshold=Попередження про поріг використання диска
WARNING=УВАГА
Warranty period=Гарантійний термін
will activate a clean system power down=активує *чисте* відключення живлення системи
will activate a clean system reset=активує *чистий* перезапуск системи
will bring the array on-line and start Clearing new data disks=переведе масив в режимі он-лайн і почне **Clearing** нових дисків з даними
will bring the array on-line and start Data-Rebuild=переведе масив у режим роботи та розпочне **Data-Rebuild**
will bring the array on-line and start Disk-Clear of new data disks=переведе масив в режимі он-лайн і почне **Disk-Clear** нових дисків з даними
will bring the array on-line and start Parity-Check=переведе масив в режимі он-лайн і почне **Parity-Check**
will bring the array on-line and start Parity-Sync=переведе масив в режимі он-лайн і запустить **Parity-Sync**
will bring the array on-line and start Parity-Sync andor Data-Rebuild=переведе масив у режим роботи та запустить **Parity-Sync** та/або **Data-Rebuild**
will bring the array on-line=приведе масив в режим он-лайн
will copy the parity information to the new parity disk=скопіює інформацію про парність на новий диск *parity*
will create a file system in all Unmountable disks=створить файлову систему на всіх **Unmountable** дисках
will delete the encryption keyfile=видалить ключовий файл шифрування
will disable the missing disk and then bring the array on-line Install a replacement disk as soon as possible=вимкне відсутній диск, а потім переведе масив у режим роботи. Встановіть замінний диск якомога швидше
will expand the file system of the data disk if possible then bring the array on-line and start Data-Rebuild=розширить файлову систему диска даних (якщо можливо); потім введіть масив в режимі он-лайн і запустіть Data-Rebuild
will immediately clear all disk statistics=негайно очистить всю статистику диска
will immediately invoke the Mover=негайно викличе Перенос
will immediately spin down all disks=негайно зупинить всі диски
will immediately spin up all disks=негайно запустить всі диски
will pause the Clearing=призупинить Очищення
will pause the Parity-Check=призупинить Перевірку на Парність
will pause the Parity-SyncData-Rebuild=призупинить Parity-Sync/Data-Rebuild
will pause the Read-Check=призупинить перевірку читання
will pause Data-Rebuild=призупинить відновлення даних
will pause Disk-Clear=призупинить очищення диска
will pause Parity-Check=призупинить перевірку на парність
will pause Parity-Sync=призупинить Parity-Sync
will pause Read-Check=призупинить перевірку читання
will record all disk information and bring the array on-line=запише всю інформацію про диск і переведе масив в режимі онлайн
will record all disk information, bring the array on-line, and start Parity-Sync=запише всю інформацію про диск, переведе масив в режимі онлайн та запустить Parity-Sync
will remove the missing cache disk and then bring the array on-line=видалить відсутній кеш-диск, а потім переведе масив в режимі онлайн
will resume the paused Clearing=відновить призупинене очищення
will resume the paused Parity-Check=відновить призупинену перевірку на Parity-Check
will resume the paused Parity-SyncData-Rebuild=відновить призупинену Parity-Sync/Data-Rebuild
will resume the paused Read-Check=відновить призупинену перевірку читання
will resume Data-Rebuild=відновити Відновлення Даних
will resume Disk-Clear=відновить Disk-Clear
will resume Parity-Check=відновить перевірку паритету
will resume Parity-Sync=відновить Parity-Sync
will resume Read-Check=відновить Read-Check
will start Clearing new data disks=почне **Очищення** нових дисків з даними
will start Parity-Sync andor Data-Rebuild=запустить **Parity-Sync** та/або **Data-Rebuild**
will start Disk-Clear of new data disks=почне **Очищення диска** нових дисків із даними
will start Parity-Check=розпочнеться **Перевірка Паритету**
will start Data-Rebuild=розпочнеться **Відновлення даних**
will start Parity-Sync=розпочнеться **Синхронізація Паритету**
will start Read-Check of all array disks=will start **Read-Check** of all array disks
will stop Parity-SyncData-Rebuild=зупинить Parity-Sync/Data-Rebuild
will stop the Parity-Check=зупинить перевірку на парність
will stop the Read-Check=зупинить перевірку читання
will stop Clearing=припиняє очищення
will stop Disk-Clear=зупинить Очищеня Диску
will stop Data-Rebuild=зупинить відновлення даних
will stop Parity-Check=зупинить Перевірку Паритету
will stop Parity-Sync=зупинить Синхронізація Паритету
will stop Read-Check=зупинить Перевірку Читання
will take the array off-line=виведе масив з мережі
Worst=Найгірший
Write corrections to parity=Записати поправки до паритету
Writes=Пише
Wrong key=Неправильний ключ
xfs_repair status=статус xfs_repair
You may not add new disks and also remove existing disks=Ви не можете додавати нові диски, а також видаляти наявні диски
your server=ваш сервер

; Sleep plugin translations
Check this=Перевір це
for more information=для отримання додаткової інформації
Make sure your server supports S3 sleep=Переконайтеся, що ваш сервер підтримує режим сну **S3**
Sleep will immediately put the server in sleep mode=**Sleep** негайно переведе сервер у сплячий режим
Sleeping=Сплячий
System in sleep mode=Система в сплячому режимі
This will put the system in sleep mode=Це переведе систему в сплячий режим
wiki entry=wiki запис

; Note: May 29, 2022 - 4 missing translations
