%s An update is available=%s: Доступне оновлення
anonymous=анонімний
Author=Автор
Check For Updates=Перевірити наявність оновлень
Checking connectivity=Перевірка підключення
checking=перевірка
Click here to install version %s=Натисніть тут, щоб встановити версію %s
Delete Plugin=Видалити плагін
DOWNGRADE TO VERSION=ВІДКАТИТИ НА ВЕРСІЮ
Enter URL of remote plugin file or local plugin file=Введіть URL-адресу файлу віддаленого або локального плагіна
ERROR=ПОМИЛКА
Install Plugin=Встановити плагін
Install=Встановити
install=встановити
Installed Plugins=Встановлені Плагіни
Installing Update=Встановлення Оновлення
need check=необхідна перевірка
Next=Далі
No plugins installed=Плагіни не встановлені
No release notes available=Примітки до випуску відсутні
No response , aborting=Немає відповіді, переривання
Plugin File=Файл Плагіна
Plugin File Install Errors=Помилка встановлення файлу плагіна
Plugin History=Історія плагіна
Plugin Update Check=Перевірка оновлення плагіна
Plugin=Плагін
Release Notes=Примітки до випуску
Remove Plugin=Видалити плагін
remove=видалити
Select local plugin file=Виберіть файл локального плагіна
Stable=Стабільний
STALE=ЗАСТАЛИЙ
Support Thread=Лінія підтримки
Uninstall=Видалення
Update All Plugins=Оновити Всі Плагіни
Update Plugin=Оновити Плагін
Upgrade=Оновлення
View Release Notes=Переглянути примітки до випуску