Add Share=Додати спільний ресурс
All files encrypted=Всі файли зашифровані
All files protected=Всі файли захищені
All files unprotected=Усі файли незахищені
Allocation method=Метод розподілу
Array must be Started to view Shares=Щоб переглянути спільні ресурси, масив має бути **запущений**
Automatically split any directory as required=Автоматично розділить будь-який каталог за потребою
Automatically split only the top five directory levels as required=За потреби автоматично розділить лише п’ять верхніх рівнів каталогу
Automatically split only the top four directory levels as required=За потреби автоматично розділить лише чотири верхні рівні каталогу
Automatically split only the top level directory as required=За потреби автоматично розділить лише каталог верхнього рівня
Automatically split only the top three directory levels as required=За потреби автоматично розділить лише три верхні рівні каталогу
Automatically split only the top two directory levels as required=За потреби автоматично розділить лише два верхні рівні каталогу
Calculated free space value=Розраховане значення вільного простору
Clean Up=Очистити
CLEAN UP=ОЧИСТИТИ
Comments=Коментар
Compute All=Розрахувати Все
Compute=Розрахувати
Disk Shares=Спільні диски
Do not use pool names=Не використовуйте назви пулів
Do not use reserved names=Не використовуйте зарезервовані імена
Enable Copy-on-write=Увімкнути копіювання під час запису
Enter a name for the share=Введіть назву для спільного використання
Excluded disks=Виключені диски
Exclusive access=Exclusive access
Export=Експорт
Fill-up=Заповнити
Free=Вільно
has been deleted=було видалено
HDD=HDD
High-water=Найвищій-Рівень
Included disks=Включений диск(и)
Invalid Characters=Недійсні символи
Invalid share name=Недійсна назва спільного ресурсу
Manual do not automatically split directories=Інструкція: не розділяти каталоги автоматично
Minimum free space=Мінімум вільного місця
Missing share name=Відсутня назва спільного ресурсу
Most-free=Найбільш-Вільний
Mover action=Ініціатор дії
Mover takes no action=Ініціатор не вживає жодних заходів
Mover transfers files from array to cache=Ініціатор передає файли з масиву в кеш
Mover transfers files from cache to array=Ініціатор передає файли з кешу в масив
Mover transfers files from Primary storage to Secondary storage=Ініціатор передає файли з основного сховища до Додаткового
Mover transfers files from Secondary storage to Primary storage=Ініціатор передає файли з додаткового сховища в Основне
next user share=спільний доступ наступного користувача
No unused share configurations present=Немає невикористаних конфігурацій спільного доступу
Not used=Не використовується
Only=Тільки
Prefer=Віддавати перевагу
previous user share=попередній користувач
Primary storage %s=Основне сховище %s
Primary storage for new files and folders=Основне сховище (для нових файлів і папок)
Primary storage to Secondary storage=Основне сховище до Вторинного сховища
Read=Читати
Recompute=Перерахувати
Remove unused share configurations=Видаліть конфігурації спільного доступу, які не використовуються
Removed share configurations=Видалені конфігурації спільного доступу
Rule=Правило
Secondary storage to Primary storage=Вторинне сховищае до Основного сховища
Secondary storage=Вторинне зберігання
Select cache pool=Виберіть пул кешу
Set when adding new share only=Встановлюється лише під час додавання нового спільного доступу
Share contains data=Спільний доступ містить дані
Share name contains invalid characters for ZFS use=Назва спільного ресурсу містить неприпустимі символи для використання ZFS
Share is empty=Спільний ресур порожній
Share is outside the list of designated disks=Спільний доступ знаходиться за межами списку призначених дисків
Share Settings=Налаштування спільного доступу
Share status=Поділитися статусом
Size=Розмір
Some or all files unencrypted=Деякі або всі файли незашифровані
Some or all files unprotected=Деякі або всі файли не захищені
Split level=Розділений рівень
SSD=SSD
Storage=Storage
There are no exportable disk shares=Немає спільних дисків для експорту
There are no exportable user shares=Немає спільних користувачів, які можна експортувати
Time Machine volume size limit=Обмеження розміру обсягу Time Machine
Unknown encryption state=Невідомий стан шифрування
Use cache pool for new filesdirectories=Використовувати пул кешу (для нових файлів/каталогів)
User Shares=Спільні ресурси користувачів
Write=Писати
You cannot use the following within share names=Ви не можете використовувати наступне в іменах спільного доступу
