20 EHCI=2.0 (EHCI)
30 nec XHCI=3.0 (nec XHCI)
30 qemu XHCI=3.0 (qemu XHCI)
Allocation=Виділення
and if using graphics device passthrough it too needs UEFI=і якщо використовується пропускний режим графічного пристрою, йому також потрібен UEFI
Are you sure=Ти впевнений
Array must be started to view Virtual Machines=Для перегляду віртуальних машин необхідно **запустити** масив
Autostart=Авто старт
Back=Назад
Bus=Шина
Capacity=Здатність
Change Icon=Змінити значок
Cleanup=Прибирати
Click and Select cdrom image to install operating system=Натисніть і виберіть образ cdrom, щоб встановити операційну систему
Config Folder=Папка конфігурації
Copy Paste Domain XML Configuration Here=Копіювати &amp; Вставте сюди конфігурацію XML домену
CPU Mode=Режим CPU
CPUs=CPUs
Create=Створити
Creating=Створення
define the amount memory=визначіть обсяг пам'яті
define the maximum amount of memory=визначіть максимальний обсяг пам'яті
define type of cpu presented to this vm=визначіть тип cpu, представленого цій віртуальній машині
description of virtual machine=опис віртуальної машини
Disk devices=Дискові пристрої
Download Folder=Завантажити папку
Download, Click and Select virtio drivers image=Завантажте, натисніть і виберіть образ драйверів virtio
Downloading=Завантаження
eg=e.g.
Emulated=Емулюється
ETA=ETA
Extracting=Видобуток
Folder to save the LibreELEC image to=Папка для збереження образу LibreELEC
Folder to save the OpenELEC image to=Папка для збереження образу OpenELEC
Form View=Перегляд форми
free=вільно
Graphics Card=Відеокарта
Graphics ROM BIOS=Графічний ROM BIOS
Graphics=Графіка
Guest not running or guest agent not installed=Гість не працює або гостьовий агент не встановлено
Host Passthrough=Передача хосту
Hyperv tweaks for Windows=Налаштування Hyperv для Windows
Hyper-V=Hyper-V
i440fx will work for most=i440fx підійде для більшості
Icon=Значок
Initial=Початковий
Interfaces=Інтерфейси
Invalid storage path=Недійсний шлях зберігання
Invalid VM to edit=Недійсна VM для редагування
IP Address=IP-адреса
ISO storage path doesnt exist=ISO storage path doesn't existШлях до зберігання ISO не існує
ISO storage path doesnt exist, please create the user share or empty folder first=Шлях до зберігання ISO не існує, спершу створіть спільний доступ користувача (або порожню папку)
ISO storage path was empty=Шлях до зберігання ISO порожній
keyboard for VNC=клавіатура для VNC
LibreELEC Version=Версія LibreELEC
LibreELEC=LibreELEC
Libvirt Service failed to start=Не вдалося запустити службу Libvirt
Logical CPUs=Логічні CPUs
Machine=Машина
Manual=Посібник
Max=Максимальний
MD5 verification failed, your download is incomplete or corrupted=Помилка перевірки MD5, ваше завантаження неповне або пошкоджене
mount tag inside vm=тег монтування всередині vm
My Workstation=Моя робоча станція
name of mount tag inside vm=ім'я тегу монтування всередині vm
Name of virtual machine=Ім'я віртуальної машини
Network Bridge=Мережевий Bridge
Network MAC=Мережа MAC
Network Model=Модель мережі
No Virtual Machines installed=Віртуальні машини не встановлені
None available=Немає в наявності
Not enough free space, need at least=Не вистачає вільного місця, потрібно принаймні
Not running=Не працює
OpenELEC Version=Версія OpenELEC
OpenELEC=OpenELEC
OS Install CDRom Bus=ОС встановити шину CDROM
OS Install ISO=ОС Встановіть ISO
Other PCI Devices=Інші пристрої PCI
OVMF requires a UEFI-compatable OS=OVMF вимагає UEFI-сумісної ОС
OVMF=OVMF
OVMF TPM=OVMF TPM
password for VNC=пароль для VNC
path of Unraid share=шлях спільного доступу Unraid
path on Unraid share to save LibreELEC settings=шлях до спільного доступу Unraid, щоб зберегти налаштування LibreELEC
path on Unraid share to save OpenELEC settings=шлях до спільного доступу Unraid, щоб зберегти налаштування OpenELEC
Path to ROM BIOS file=Шлях до файлу ROM BIOS
Please choose a folder the LibreELEC image will download to=Будь ласка, виберіть папку, до якої буде завантажено зображення LibreELEC
Please choose a folder the OpenELEC image will download to=Будь ласка, виберіть папку, до якої буде завантажено зображення OpenELEC
Pop-up Blocker is enabled Please add this site to your exception list=Блокувальник спливаючих вікон увімкнено! Будь ласка, додайте цей сайт до свого списку винятків
Prefix=Префікс
Primary=Первинний
Q35 for a newer machine model with PCIE=Q35 для новішої моделі машини з PCIE
QEMU64=QEMU64
random mac, you can supply your own=випадковий mac, ви можете надати свій власний
re-generate random mac address=повторно генерувати випадкову mac-адресу
Remove LibreELEC image=Видалити образ LibreELEC
Remove OpenELEC image=Видалити образ OpenELEC
Remove this LibreELEC file=Видалити цей файл LibreELEC
Remove this OpenELEC file=Видалити цей файл OpenELEC
SeaBIOS will work for most=SeaBIOS підійде для більшості
SeaBIOS=SeaBIOS
Select the BIOS=Виберіть BIOS
Select the LibreELEC version to use=Вибервти версію LibreELEC для використання
Select the machine model=Виберіть модель машини
Select the OpenELEC version to use=Виберати версію OpenELEC для використання
Select the USB Controller to emulate=Виберати контролер USB для емуляції
Separate sub-folder and image will be created based on Name=На основі Імені буде створено окрему підпапку та образ
shares=спільний доступ
Some OSes wont support USB3=Деякі ОС не підтримують USB3
Sound Card=Звукова карта
Specify a ISO storage path first=Спочатку вкажіть шлях зберігання ISO
Start All=Запустити ВСІ
Start VM after creation=Запустити віртуальну машину після створення
Stop All=Зупинити ВСІ
Toggle VM autostart=Увімкнути автозапуск VM
type of storage image=тип образу для зберігання
Unknown action=Невідома дія
Unknown version=Невідома версія
Unraid Mount tag=Тег монтування Unraid
Unraid Share=Спільний доступ Unraid
Updating=Оновлення
USB Controller=USB-контролер
USB Devices=USB-пристрої
vDisk Bus=шина vDisk
vDisk Location=Розташування vDisk
vDisk Size=Розмір vDisk
vDisk Type=Тип vDisk
vDisks=vDisks
Verifying=Перевірка
video for VNC=відео для VNC
VirtIO Drivers CDRom Bus=Драйвери VirtIO шини CDROM
VirtIO Drivers ISO=Драйвери VirtIO ISO
Virtual Machines=Віртуальні Машини
VM creation error=Помилка створення VM
VM image deletion error=Помилка видалення образу VM
VNC Keyboard=Клавіатура VNC
VNC Password=Пароль VNC
VNC Video Driver=Відео драйвер VNC
VNC=VNC
Wasnt able to stop the process=Не вдалося зупинити процес
Windows 7XP=Windows 7/XP
Windows 82012, newer Linux distros=Windows 8/2012, новіші Linux дистрибутиви
XML View=Перегляд XML
